	countryID	country
	AT	Austrija
	BY	Baltarusija
	BG	Bulgarija
	DK	Danija
	IE	Airija
	EE	Estija
	CZ	Čekija
	FI	Suomija
	FR	Prancūzija
	DE	Vokietija
	GR	Graikija
	HR	Kroatija
	HU	Vengrija
	IT	Italija
	LV	Latvija
	LT	Lietuva
	SK	Slovakija
	LU	Liuksemburgas
	MT	Malta
	NL	Olandija
	NO	Norvegija
	PL	Lenkija
	PT	Portugalija
	RS	Serbija
	RO	Rumunija
	RU	Rusija
	SI	Slovėnija
	ES	Ispanija
	SE	Švedija
	CH	Šveicarija
	TR	Turkija
	GB	Didžioji Britanija
	UA	Ukraina
	AL	Albanija
	BA	Bosnija ir Herzegovina
	GE	Gruzija
